WWWWWWWWWWWWWWWWWWWW
W.P................W
W..................W
W..................W
W..................W
W...........WWW....W
W...........W.W....W
W...........W.W....W
W...........W.WWWWWW
W...........W......W
W...........W.WWWWWW
W.......WWWWW.W....W
W.......W.....W....W
W.......WWWWWWW....W
W..................W
W..................W
W..................W
W..................W
W..................W
WWWWWWWWWWWWWWWWWWWW