....................
QWWWWWWWWWWWWWWWWWWE
AXXXXXXXXXGXXXXXXXXD
A........XPX.......D
A........X.X.......D
A........X.X.......D
A........X.X.......D
A........X.X.......D
A.......XX.XX......D
A.......X...X......D
A.......XX.XX......D
A........X.X.......D
A........X.X.......D
A........X.X.......D
A........X.X.......D
A....XXXXX.XXXXX...D
A....X.........X...D
A....X....K....X...D
A....X.........X...D
A....X....H....X...D
ZSSSSSSSSSSSSSSSSSSC