...H................
QWWWWWWWWWWWWWWWWWWE
AXXXXXXXXXPXXXXXXXXD
A........X.X.......D
A........X.X.......D
A........X.X.......D
A........X.X.......D
A........X.X.......D
A.......XX.XX......D
A.......X...X......D
A.......XX.XX......D
A........X.X.......D
A........X.X.......D
A........X.X.......D
A........X.X.......D
A....XXXXX.XXXXX...D
A....X.........X...D
A....X....K....X...D
A....X.........X...D
A....X.........X...D
ZSSSSSSSSSSSSSSSSSSC