QWWWWWWWWWWWWWWWWWWE
AP.................D
A..................D
A..................D
A..................D
A...........XXX....D
A...........X.X....D
A...........X.X....D
A...........X.XXXXXD
A...........X......D
A...........X.XXXXXD
A.......XXXXX.X....D
A.......X.....X....D
A.......XXXXXXX....D
A..................D
A..................D
A..................D
A..................D
A..................D
ZSSSSSSSSSSSSSSSSSSC