....H............I..
WWWWWWWWWWWWWWWWWWWW
WGP................W
W..................W
W..................W
W..................W
W..................W
W..................W
W..................W
W........K.........W
W.................HW
W..................W
W..................W
W..................W
W..................W
W..................W
W..................W
W..................W
W..................W
W..................W
WWWWWWWWWWWWWWWWWWWW