....................
QWWWWWWWWWWWWWWWWWWE
AGP................D
A..................D
A..................D
A..................D
A..................D
A..................D
A..................D
A..................D
A....B......F......D
A..................D
A..................D
A..................D
A..................D
A..................D
A.................HD
A..................D
A..................D
A..................D
ZSSSSSSSSSSSSSSSSSSC