WWWWWWWWWWWWWWWWWWWW
WP.................W
W..................W
W..................W
W..................W
W..................W
W..................W
W..................W
W..................W
W....B.............W
W..................W
W..................W
W..................W
W..................W
W..................W
W..................W
W..................W
W..................W
W..................W
WWWWWWWWWWWWWWWWWWWW