....................
WWWWWWWWWWWWWWWWWWWW
WGP................W
W..................W
W..................W
W..................W
W..................W
W..................W
W..................W
W..................W
W....B......F......W
W..................W
W..................W
W..................W
W..................W
W..................W
W.................HW
W..................W
W..................W
W..................W
WWWWWWWWWWWWWWWWWWWW