....H............I..
WWWWWWWWWWWWWWWWWWWW
WP.................W
W..................W
W..................W
W..................W
W..................W
W..................W
W..................W
W........K.........W
W..................W
W..................W
W..................W
W..................W
W..................W
W..................W
W..................W
W..................W
W..................W
W..................W
WWWWWWWWWWWWWWWWWWWW